11111111111111111111111111
14222222222222222121222241
12221111211112222221211121
11222221212212121222212221
12221111222112122222222221
12122212212122111212112121
12221211111132222222212121
12221222222222222222222221
12111222212112121111222221
12222221222222111222222121
12211211212222222222112121
14222222222122222222122261
11111111111111111111111111
