11111111111111111111111111
10000000000000000000000001
10110000111010100000100101
10100111000000000000100101
10000000000000000000100101
10100100000101000000100101
10000001000010000000100101
10000000000101000000000001
10110000100000000000100101
10100111000001000000100101
10000000000010100000100101
10100111101001000000100101
11111111111111111111111111
