11111111111111111111111111
10000000000000000000000001
10110220111010100000100101
10100111000000000000100101
10000022220000222220100101
10100100000141000000100101
10000001000410000030100101
10022222200101000000000001
10110000100222222200100101
10100111000001002220100101
10000000000010100000100101
10100111101001000000100101
11111111111111111111111111
