111111111111111111111111111111111
121212122212121212121212221212121
121222121212421212122212121222121
122212221222122412221222122212221
111211121112111221121112111211121
121222121212221212122212121222121
121622121212221212122412141242121
122212221242122212221222122212221
111211111111121111121111111112111
121212121212121212121212121212121
121222121214221212122212121222121
122212221222122212221222122212221
111211121114111211121114111211121
121222121412421212122212121222121
121242122212221212122212221222121
122212222222122212221222222212221
111112111111111111111112121111111
121212122314121214121212221212121
121222121212221212122212121222121
122212221222122212221222122212221
111211121112111211121112111211121
121222121212221212122214121222121
121222121212221212122212121222121
122212221222122212221222122212221
111211111111121121121111111112111
121512121212121212121212121212121
121222121212221212122212121222121
142212221222122212221222124212221
111211121112111211121112111211121
121222121212221212122212121222121
141222122212221412122212221222121
122212222222122222221224222212221
111111111111111111111111111111111
