11111111111111111111111111111111111111111111111111111111111111111
12121212121212121412121212121212121212121212121212121212121212121
12122212121222121212221212122212121222121212221212122212121222121
12221222122214221222122212221222122212221222122212221222122212221
11121112111211121112111211121112111211121112111211121112111211121
12121212121212121212121212121412121212121214121212121212121212121
12121212121212121212121212121212121212121212121212121212121212121
12222222222222221222222222222222122222222222222212222222222222221
11121111111211121112111111121112111211111112111211121111111211121
12121212221212121212121222141212121212122212121212121215221212121
12122212121222121212221212122212121222121212221212122212121222121
12221222122212222222122212221222122212221222122222221222122212221
11121112211211121112111221121112111211122112111211121112211211121
12121212121212121412121212121212121212121212121212121212121212121
12121212121212121212121212121212121212121212121212121212121212121
12222222122222221222222212222222122222221222222212222222122222221
11111111111112111111111211121111211111111111121111111112111211111
12121212121212121212121212121212121212121212121212121212121212121
12122212121222121212221212122212121222121212221212122212121222121
14221222122212221222122212221222142212221222122212221222122212221
11121112111211121112111211121112111211121112111211121112111211121
12121212121212121212121212121212121212121212121212121212121212121
12121212121212121212121212121212121212121212121212121212121212121
12222224222222221222222222222222122222222222222212222222222222221
11121111111211121112111111121112111211111112111211121111111211121
12121212221212122212121222121212121212122212121222121212221212121
12122212121222121212221212122212121222121212221212122212121222121
12221222122212221222122212221222122212221222122212221222122212221
11121112211211121112111221121112111211122112111211121112211211121
12121212121212121212121212121212121212121212121212121212121412121
12121212121212122212121212121212121212121212121222121212121212121
12222222122224221222222212222222122222221222222212222222122222221
11111111111111111111111112111111111112111111121111111111111111111
12121212121212121212121212121212121212121212121212121212121212121
12122212121422121212241212122212121222121213221212122212121222121
12221222122212221222122212221222222212221222122212221222122212221
11121112111211121112111211121112111211121112111211121112111211121
12121212121212121212121212121212121212121212121212121212121412121
12121212121212121212121212121212121212121212121212121212121212121
12222222222222241222222222222222122222222222222212222222222222221
11121111111211121112111111121112111211111112111211121111111211121
12121212221212121212121222121212121212122212121212121212221212121
12122212121222121212221212122212121222121212221212122212121224121
12221222122212222222122212221222122212221222122222221222122212221
11121112211211121112111221121112111211122112111211121112211211121
12121212121212121212121212121212121212121212121212121212121212121
12121212121212121212121212121212121212121212121212121212121212121
12222222122222221222222212222222122222221222222212222222122222221
11111111111112111111111211121111111111111111121111111112111211111
12121212121212121212121212121212121212121212121212121212121212121
12122212121222121212221212122212121222121212221212122212121222121
12221222122212221222122212221222122212221222122212221222122212221
11121112111211121112111211121112211211121112111211121112111211141
12121212121212121212121212121212121212121212121212121212121212121
12121212121212121212121212121212121212121212121212121212121212121
12222222222222221222222222222222122222222222222212222222222222221
11121111111211121112111111121112111211111112111211121111111211121
12121212221212122212121222121212121212122212121222121212221212121
12122212121222121212221212122212121222121212221212122212121222121
12221222122212221222122212221222122212221222122212221222122212221
11121112211211121112111221121112111211124112111211121112211211121
12121212121216121212121212121212121212121212121212121212121212121
12121212121212122212121212121212121212121212121222121212121212121
12222222122222221224222212222222122222221222222214222222122222221
11111111111111111111111111111111111111111111111111111111111111111
